[
  [
    { "x": 400, "y": -100 },
    { "x": 400, "y": 100 },
    { "x": 600, "y": 100 },
    { "x": 600, "y": 300 },
    { "x": 400, "y": 300 },
    { "x": 400, "y": 500 }
  ],
  [
    { "x": 0, "y": 100 },
    { "x": 400, "y": 100 },
    { "x": 400, "y": 300 },
    { "x": 200, "y": 300 },
    { "x": 200, "y": 500 },
    { "x": 600, "y": 500 },
    { "x": 600, "y": 100 },
    { "x": 800, "y": 100 }
  ],
  [
    { "x": 0, "y": 200 },
    { "x": 300, "y": 200 },
    { "x": 300, "y": 400 },
    { "x": 500, "y": 400 },
    { "x": 500, "y": 300 },
    { "x": 600, "y": 300 },
    { "x": 600, "y": 100 },
    { "x": 800, "y": 100 }
  ]
]
